--------------------------------------------------
---------.......------------------.......---------
--------......----------------------......--------
-------.....--------------------------.....-------
------.....----------------------------.....------
-----....--------------------------------....-----
----....----------------------------------....----
---............................................---
--.....-----------------..-----------------.....--
-....-.-----------------..................-.-....-
-....-.-----------------..-...............-.-....-
-...--.-----------------..-...............-.--...-
-..---.-----------------..-...............-.---..-
-..---.-----------------..-...............-.---..-
-.----.-----------------..-...............-.----.-
-.----.-----------------..-...............-.----.-
------.-----------------..-...............-.------
------.-----------------..-...............-.------
------.-----------------..-...............-.------
------.-----------------..-...............-.------
------.-----------------..-...............-.------
------.-----------------..-...............-.------
------.-----------------..-...............-.------
------.-----------------..-----------------.------
------......................................------
------.-----------------..-----------------.------
------.-...............-..-----------------.------
------.-...............-..-----------------.------
------.-...............-..-----------------.------
------.-...............-..-----------------.------
------.-...............-..-----------------.------
------.-...............-..-----------------.------
------.-...............-..-----------------.------
-.----.-...............-..-----------------.----.-
-.----.-...............-..-----------------.----.-
-..---.-...............-..-----------------.---..-
-..---.-...............-..-----------------.---..-
-...--.-..................-----------------.--...-
-....-.-...............-..-----------------.-....-
--...-.-----------------..-----------------.-....-
---.............................................--
----...------------------------------------....---
-----...----------------------------------....----
------...--------------------------------....-----
-------....----------------------------.....------
--------....--------------------------.....-------
---------.....----------------------......--------
----------......------------------.......---------
--------------------------------------------------
