-------------------------
|-----------------------|
|------....f........----|
|------.----------.-----|
|...sl...........-.-----|
|------.------.-.-.-----|
|------.------.-.-.-----|
|------.----u-...-.-----|
|------.----.-...-.-----|
|--..............-.-----|
|--.---.----------.-----|
|--.---.----------.-----|
|--....s.....-----......|
|-----------------......|
-------------------------