-------------------------
|.||||||||||||||..|.....|
|.||||||||||||.|..|.....|
|.|||||||......|..|.....|
|....||.|......|..|.....|
|.....|.|......||.|.....|
|.....|.|......|..|.....|
|.....|.|......|..|.....|
|.....|.|..ff..|..|.....|
|.....|.|......|..|.....|
|.....|.|......|..|.....|
|.....|.|......|..|.....|
|.....|...........|.....|
|.................|.....|
-------------------------