-------------------------
-|||||||||||||||........|
||||||||||||||..........|
||||||||||||||..........|
||.||||.||||||.|........|
||.||||.||||||.||.......|
||.||||.||||||.||.......|
|.....|........||.......|
|.....|..||||..||.......|
|.....|.||||||.||.......|
|.....|.||||||.||.......|
|.....|.||||||.||.......|
|.....|.||||||.|||......|
|.......||||||.||||.....|
-------------------------