-.-----------------------
|.||||||||||||||........|
|.||||||||||||..........|
|.||||||||||||..........|
|....||.||||||.|........|
|.....|.||||||.||.......|
|.....|.||||||.||.......|
|.....|........||.......|
|.....|..||||..||.......|
|.....|.||||||.||.......|
|.....|.||||||.||.......|
|.....|.||||||.||.......|
|.....|.||||||.|||......|
|.......||||||.||||.....|
-----------------------.-