-------------------------
|.|||||||......|..|.....|
|.|||||||......|..|.....|
|.|||||||......|..|.....|
|....||.|......|..|.....|
|.....|.|......||.|.....|
|.....|.|..ff..|..|.....|
|.....|.|......|..|.....|
|.....|.|......|..|.....|
|.....|.|......|..|.....|
|.....|.|......|..|.....|
|.....|.|......|..|.....|
|.....|...........|.....|
|.................|.....|
-------------------------