----------------------.---------------------
----------------------.---------------------
----------------------.---------------------
----------------------.---------------------
----------------------.---------------------
----------------------.---------------------
----------------------.---------------------
----------------------.---------------------
----------------------.---------------------
----------------------.---------------------
----------------------.---------------------
----------------------.---------------------
----------------------.---------------------
---------------------..---------------------
--------------|*`..*`.,-.|`..|--------------
..*`..*.*-*`.*|*`..*`.,,..|..|`.,`,*`..*`.,.
.*...*`..*`..,.*`..*`.,--|`..|`.,`,*`..*`.,.
*`..*`.,`,*`..|*`..*`.---*`..|`.,`,*`..*`.,.
*`..*`.,`,*`..|*`..*`.,`,*`..|`.,`,*`..*`.,.
*`..*`.,`,*`..|*`..*`.,`,*`..|`.,`,*`..*`.,.
.*`.,`...*`.,`|*`..*`.,`,*`..|`.,`,*`..*`.,.
-------.------|*`..*`.,`,*`..|--------------
*`..*`.,`,.,.,|*`..*`.,`,*`..|`.,`,*`..*`.,.
.*`.,`-.*`.,`,|*`..*`.,`,*`..|`.,`,*`..*`.,.
..*`..*`.,`,*`|*`..*`.,`,*`..|`.,`,*`..*`.,.
..*`..*`.,`,*`|*`..*`.,`,*`..|.,`,*`..*`.,.
..*`..*`.,`,*`|*`..*`.,`,*`..|`.,`,*`..*`.,.
..*`..*`.,`,*`|*`..*`.,`,*`..|`.,`,*`..*`.,.
..*`..*`.,`,*`|*`..*`.,`,*`..|`.,`,*`..*`.,.
..*`..*`.,`,*`|*`..*`.,`,*`..|`.,`,*`..*`.,.