$-------------------------------------$----------------%
|+++++++++++++++++++++++++++++++++++++|++++++++++++++++|
|+++++++++++++++++++++++++++++++++++++|+|-------------+|
|+++++++++++++++++++++++++++++++++++++|+|++++++++++++|+|
|+++++++++++++++++++++++++++++++++++++|+|+++|-------+|+|
|+++++++++++++++++++++++++++++++++++++|+|+++|++++++|+|+|
|+++++++++++++++++++++++++++++++++++++|+|+++|+|---+|+|+|
|-----|--------------|++++++++++++++++|+|+++|+|++|+|+|+|
|+++++|++++++++++++++|++++++++++++++++++|+++|+|++++|+|+|
|+++++|++++++++++++++|++++++++++++++++++++++|+|++++|+|+|
|+++++|++++++++++++++|++++++++++++++++|+++++|+|++++|+|+|
|+++++|++++++++++++++|++++++++++++++++|+++++|+|++++|+|+|
|++++slf++++++++++++fl++++u+++++++++++||++++|+|++++|+|+|
|+++++|++++++++++++++|++++++++++++++++||++++|+-----|+|+|
|+++++|++++++++++++++|++++++++++++++++|||f|+|++++++++|+|
|++u++|++++++++++++++|++++++++++++++++|||`|+---------|+|
!+++++|++++++++++++++|++++++++++++++++|||||++++++++++++#
$-----------------------c------------------------------$