$-------------------------------------$----------------%
|++++++++++++++++++++++++++++++++++++++++++++++++++++++|
|++++++++++++++++++++++++++++++++++++++++++++++++++++++|
|++++++++++++++++++++++++++++++++++++++++++++++++++++++|
|++++++++++++++++++++++++++++++++++++++++|s++++++++++++|
|++++++++++++++++++++++++++++++++++++++++++++++++++++++|
|------------------------------l---------+--------|----|
|------------------------------+---------+--------|++++|
|+++++|++++++++++++++|+++++++++++++++++++++++++++sl++++|
|+++++|++++++++++++++|++++++++++++++++++++++++++++||+|+|
|+++++u++++++++++++|++++++++++++++++++++++++++++++||+|+|
|+++++|++++++++++++++|++++++++++++++++++++++++++++||+|+|
|++++slf++++++++++++fl++++++++++++++++++++++++++++||+|+|
|+++++|++++++++++++++|++++++++++++++++++++++++++++|++++|
|+++++|++++++++++++++|++++++++++++++++++++++++++++++|++|
|+++++|++++++++++++++|++++++++++++++++++++++++++++|++++|
!+++++|++++++++++++++|+++++++++++++++++++|+|++++++|+|+||
$-----------------------c------------------------------$