$-----------a------------------------------------------%
|++++++++++|+++++++++++++++++++++++++++++++++++++++++++|
|++++++++++++++++++++++++++++++++++++++++++++++++++++++|
|++++++++++++++++++++++++++++++++++++++++++++++++++++++|
|++++++++++++++++++++++++++++++++++++++++++++++++++++++|
|++++++++++++++++++++++++++++++++++++++++++++++++++++++|
|++++++++++++++++++++++++++++++++++++++++++++++++++++++|
|++++++++++++++++++++++++++++++++++++++++++++++++++++++|
|++++++++++++++++++++++++++++++++++++++++++++++++++++++|
|++++++++++++++++++++++++++++++++++++++++++++++++++++++|
|---------------------+++++++++++++++++++++++++++++++++|
|++++++++++++++++++++++++++++++++++++++++++++++++++++++|
|++++++++++++++++++++++++++++++++++++++++++++++++++++++|
|++++++++++++++++++++++++++++++++++++++++++++++++++++++|
|++++++++++++++++++++++++++++++++++++++++++++++++++++++|
|++++++++++++++++++++++++++++++++++++++++++++++++++++++|
|++++++++++++++++++++++++++++++++++++++++++++++++++++++|
|++++++++++++++++++++++++++++++++++++++++++++++++++++++|
|++++++++++++++++++++++++++++++++++++++++++++++++++++++|
|++++++++++++++++++++++++++++++++++++++++++++++++++++++|
|++++++++++++++++++++++++++++++++++++++++++++++++++++++|
|+++++++++++++++++++++++++++++++++++++$----------------|
|+++++++++++++++++++++++++++++++++++++|++++++++++++++++|
|+++++++++++++++++++++++++++++++++++++|++++++++++++++++|
|+++++++++++++++++++++++++++++++++++++|++++++++++++++++|
|+++++++++++++++++++++++++++++++++++++|++++++++++++++++|
|+++++++++++++++++++++++++++++++++++++|++++++++++++++++|
|+++++++++++++++++++++++++++++++++++++|++++++++++++++++|
|+++++++++++++++++++++++++++++++++++++|++++++++++++++++|
|++++++++++++++++++++++++++++++++++++++++++++++++++++++|
|++++++++++++++++++++++++++++++++++++++++++++++++++++++|
|+++++++++++++++++++++++++++++++++++++|++++++++++++++++|
|+++++++++++++++++++++++++++++++++++++|++++++++++++++++|
|+++++++++++++++++++++++++++++++++++++||+++++++++++++++|
|+++++++++++++++++++++++++++++++++++++||+++++++++++++++|
|+++++++++++++++++++++++++++++++++++++|||f|++++++++++++|
|+++++++++++++++++++++++++++++++++++++|||`|++++++++++++|
!+++++++++++++++++++++++++++++++++++++|||||++++++++++++#
$------------------------------------------------------$