$66666666666116666666666%
5424343421124132112342235
5134141242314214342144115
5233441234123414233141415
5332212121324423441334215
5321113332332222331413325
1234321413421141341123431
1234323233131334242143121
5233422423434232112341235
5343442341231241233424225
5314143223341243424324145
5234433234234234211413235
5234324234342413414123425
5423431234214132124142335
!66666666666116666666666#