23412334241231234123412343212312314234123412
12342323123412321341234123421234231231234231
23412334241231234123412343212312314234123412
12342355555552321341234123421234231231234231
23412355555551234123412343212312314234123412
12342355555552321341234123421234231231234231
23412355555551234123412343212312314234123412
12342355555552321341234123421234231231234231
234123555b5551234123412343212312314234123412
12342323523212121341234123421234231231234231
12342323123212121341234123421234231231234231
12342323123212121341234123421234231231234231
12342323123212121341234123421234231231234231
12342323123212121341234123421234231231234231
12342323123212121341234123421234231231234231
12342323123212121341234123421234231231234231
12342323123212121341234123421234231231234231
55555555555555621341234123421234231231234231
23412334251231634123412343212312314234123412
123u2323123412221341234123421234231231234231
23412334241231634123412343212312314234123412
12342323123412621341234123421234231231234231
23412334241231634123412343212312314234123412
1234231f123412621341234123421234231231234231
5555555l555555634123412343212312314234123412
12342321123412621341234123421234231231234231
12342353123412621341234123421234231231234231
23412334241131634123412343212312314234123412
12342323123112621341234123421234231231234231
23412334241131634123412343212312314234123412
12342323123112621341234123421234231231234231
23412334241231634123412343212312314234123412
12342323123212621341234123421234231231234231