|----------------------------|
|.......||||||||||||||||||||||
|.......||||||||||||||||||||||
|.......||||||||||||||||||||||
|.......||||||||||||||||||||||
|............................|
|............................|
|............................|
|............................|
|............................|
|............................|
|............................|
|............................|
|............................|
|............................|
|............................|
|............................|
|............................|
|............................|
|............................|
|............................|
|............................|
|............................|
|............................|
|............................|
||||||||||||||||||||||.......|
||||||||||||||||||||||.......|
||||||||||||||||||||||.......|
||||||||||||||||||||||.......|
|----------------------------|
