|----------------------------|
|.......||||||||||||||||||||||
|.......||||||||||||||||||||||
|.......||||||||||||||||||||||
|.......||||||||||||||||||||||
|............................|
|............................|
|............................|
|............................|
|............................|
|............................|
|............--g--...........|
|............|...|...........|
|............g...g...........|
|............|...|...........|
|............--g--...........|
|............................|
|............................|
|............................|
|............................|
|............................|
|............................|
|............................|
|............................|
|............................|
||||||||||||||||||||||.......|
||||||||||||||||||||||.......|
||||||||||||||||||||||.......|
||||||||||||||||||||||.......|
|----------------------------|
