1214243414123412412343234
1424343421124132112342231
2134141242314214342144114
1233441123412114233141412
4332211121324223441334214
4321114332332322331413322
1234323413421441341123434
1234322233131234242143123
1233421423434332112341234
2343441234123441233424224
2314143223341243424324142
1234433234234234211413234
1234324234342413414123423
1423431234214132124142331
1423432141234123434321421