.`.*`*,*.*.`,*.`*.`,*,`,*
.*`*,*,*`..`*.,`..`,*``,.
`.,*.*.`*`,.*`.*,*`.**..*
.`,,**..`,*.`..*`,,.*.*.`
*,,``...`.,`*``,**.,,*`.*
*,`...*,,`,,`,``,,.*.,,``
.`,*,`,*.,*`.**.,*..`,*,*
.`,*,```,,.,.`,*`*`.*,.`,
.`,,*`.*`,*,*,,`..`,*.`,*
`,*,**.`,*.`,**.`,,*`*``*
`,.*.*,``,,*.`*,*`*,`*.*`
.`,**,,`,*`,*`,*`..*.,`,*
.`,*,`*`,*,*`*.,*.*.`,*`,
.*`,*,.`,*`.*.,`.`*.*`,,.
.*`,*,`.*.`,*.`,*,*,`.*`.