1214243414123412412343234
1424343421124132112342231
2134141242314214342144114
1233441243114414233141412
4332212121324123441334214
4321112332332322331413322
1234322413421341341123434
1234321233131234242143123
1233423423434232112341234
2343442312342341233424224
2314143223341243424324142
1234433234234234211413234
1234324234342413414123423
1423431234214132124142331
1423432141234123434321421