+++++++++++++++++++++++++++++
+++++++++++$----------------%
+++++++++++l++++++++++++++++|
+++++++++++|+---------+----+|
+++++++++++|+|++++++++++++++|
+++++++++++|+|++-----------+|
+++++++++++|+|++++++++++++++|
+++++++++++|+--+|----------+|
+++++++++++|++++|+++++++++++|
+++++++++++|++---+++++++++++|
+++++++++++|++++++++++++++++|
+++++++++++|++++++++++++++++|
+++++++++++|++++++++++++++++|
+++++++++++|++++++++++++++++|
+++++++++++|++++++++++++++++|
+++++++++++|++++++++++++++++|
+++++++++++++|++++++++++++++|
+++++++++++!++++++++++++++++#
+++++++++++$----------------$