$-----------------------------------------------------------%
|||+++++++|+++++|+++++++++++++++++++++++++++++++++++++++++++|
|||+++++++|+++++|+++++++++++++++++++++++++++++++++++++++++++|
|||+++++++++++++|+++++++++++++++++++++++++++++++++++++++++++|
|+l+++++++|+++++|+++++++++++++++++++++++++++++++++++++++++++|
|+|+++++++|+++++|+++++++++++++++++++++++++++++++++++++++++++|
|+|+++++++|+++++|+++++++++++++++++++++++++++++++++++++++++++|
|f|+++++++|+++++|+++++++++++++++++++++++++++++++++++++++++++|
|+|+++++++|+++++|+++++++++++++++++++++++++++++++++++++++++++|
|||--------+++++--------------------------------------------|
||++++++++++++++++++++++++++++++++++++++++++++++++++++++++++|
||++++++++++++++++++++++++++++++++++++++++++++++++++++++++++|
||++++++++++++++++++++++++++++++++++++++++++++++++++++++++++|
||++++++++++++++++++++++++++++++++++++++++++++++++++++++++++|
|-------------------------------+++++-----------------------|
|++++++++++++++++++++++++++++++|+++++|++++++++++++++++++++++|
|++++++++++++++++++++++++++++++|+++++|++++++++++++++++++++++|
|++++++++++++++++++++++++++++++|+++++|++++++++++++++++++++++|
|+++++++++++++++++++++++++++++++++++++++++++++++++++++++++++|
|++++++++++++++++++++++++++++++|+++++|++++++++++++++++++++++|
|++++++++++++++++++++++++++++++|+++++|++++++++++++++++++++++|
|++++++++++++++++++++++++++++++|+++++|++++++++++++++++++++++|
|++++++++++++++++++++++++++++++|+++++|++++++++++++++++++++++|
|++++++++++++++++++++++++++++++|+++++|++++++++++++++++++++++|
|++++++++++++++++++++++++++++++|+++++|++++++++++++++++++++++|
$-----------------------------------------------------------$