$-----------------------------------------------------%
|||+++++++|+++++++++++++++++++++++++++++++++++++++++++|
|||+++++++|+++++++++++++++++++++++++++++++++++++++++++|
|||+++++++++++++++++++++++++++++++++++++++++++++++++++|
|+l+++++++|+++++++++++++++++++++++++++++++++++++++++++|
|+|+++++++|+++++++++++++++++++++++++++++++++++++++++++|
|+|+++++++|+++++++++++++++++++++++++++++++++++++++++++|
|f|+++++++|+++++++++++++++++++++++++++++++++++++++++++|
|+|+++++++|+++++++++++++++++++++++++++++++++++++++++++|
|||-------------------++++++++++++++++++++++++++++++++|
||++++++++++++++++++++++++++++++++++++++++++++++++++++|
||++++++++++++++++++++++++++++++++++++++++++++++++++++|
||++++++++++++++++++++++++++++++++++++++++++++++++++++|
|+++++++++++++++++++++++++++++++++++++++++++++++++++++|
|+++++++++++++++++++++++++++++++++++++++++++++++++++++|
|+++++++++++++++++++++++++++++++++++++++++++++++++++++|
|+++++++++++++++++++++++++++++++++++++++++++++++++++++|
$-----------------------------------------------------$