$-----------------------------------------------------------%
|||+++++++|+++++|++++++++++++++++++++++++++++++++++++|------|
|||+++++++|+++++|++++++++++++++++++++++++++++++++++++++-----|
|||+++++++++++++++|++++++++++++++++++++++++++++++++++++-----|
|+l+++++++|+++++|++++++++++++++++++++++++++++++++++++++-++++|
|+|+++++++|+++++|++++++++++++++++++++++++++++++++++++-++++++|
|+|+++++++|+++++|++++++++++++++++++++++++++++++++++++++-++++|
|f|+++++++|+++++|++++++++++++++++++++++++++++++++++++++-----|
|+|+++++++|+++++|++++++++++++++++++++++++++++++++++++++-----|
|||+++++++|+++++|++++++++++++++++++++++++++++++++++++|------|
|||--------+++++--------------------------------------------|
||++++++++++++++++++++++++++++++++++++++++++++++++++++++++++|
||++++++++++++++++++++++++++++++++++++++++++++++++++++++++++|
||++++++++++++++++++++++++++++++++++++++++++++++++++++++++++|
||++++++++++++++++++++++++++++++++++++++++++++++++++++++++++|
||------------------------------++++--------------------+---|
||++++++++++++++|++++++++++++++|++++|---+---+---+---+---+---|
|+++++++++++++++|++++++++++++++|++++||+|+|+|+|+|+|+|+|+|+|+||
||++++++++++++++|++++++++++++++|++++|--|+--|+--|+--|+|-|+--||
||++|++++++++++sl+++++++++++++++++++l+f+++f+++s+++s+++f+++++|
||++|+++++++++++|++++++++++++++|++++|---+---+---+---+---+---|
|||+++++++++++--|++++++++++++++|++++||+|+|+|+|+|+|+|+|+|f|+||
|++f++++++++++|++++++++++++++++|++++|--|+|-|+---+---+--|+--||
|||+++++++++++|+|++++++++++++++|++u+|u++++f+++f+++s+++s+++++|
||++++++++++++|+|++++++++++++++|++++|---+---+---+---+---+---|
|||+|+++++++++|+|++++++++++++++|++++||+|+|+|+|+|+|+|+|+|+|+||
----------------------------------+-----+---+---+---+---+--||
$-----------------------------------------------------------$