$-----------------------------------------------------------%
|||+++++++|+++++|++++++++++++++++++++++++++++++++++++|------|
|||+++++++|+++++|++++++++++++++++++++++++++++++++++++++-----|
|||+++++++++++++++|++++++++++++++++++++++++++++++++++++-----|
|+l+++++++|+++++|++++++++++++++++++++++++++++++++++++++-++++|
|+|+++++++|+++++|++++++++++++++++++++++++++++++++++++-++++++|
|+|+++++++|+++++|++++++++++++++++++++++++++++++++++++++-++++|
|f|+++++++|+++++|++++++++++++++++++++++++++++++++++++++-----|
|+|+++++++|+++++|++++++++++++++++++++++++++++++++++++++-----|
|||+++++++|+++++|++++++++++++++++++++++++++++++++++++|------|
|||--------+++++--------------------------------------------|
||++++++++++++++++++++++++++++++++++++++++++++++++++++++++++|
||++++++++++++++++++++++++++++++++++++++++++++++++++++++++++|
||++++++++++++++++++++++++++++++++++++++++++++++++++++++++++|
||++++++++++++++++++++++++++++++++++++++++++++++++++++++++++|
|-------------------------------+++++-----------------------|
|++++++++++++++++++++++++++++++|+++++|++++++++++++++++++++++|
|++++++++++++++++++++++++++++++|+++++|++++++++++++++++++++++|
|++++++++++++++++++++++++++++++|+++++|++++++++++++++++++++++|
|+++++++++++++++++++++++++++++++++++++++++++++++++++++++++++|
|++++++++++++++++++++++++++++++|+++++|++++++++++++++++++++++|
|++++++++++++++++++++++++++++++|+++++|++++++++++++++++++++++|
|++++++++++++++++++++++++++++++|+++++|++++++++++++++++++++++|
|++++++++++++++++++++++++++++++|+++++|++++++++++++++++++++++|
|++++++++++++++++++++++++++++++|+++++|++++++++++++++++++++++|
|++++++++++++++++++++++++++++++|+++++|++++++++++++++++++++++|
$-----------------------------------------------------------$