$-----------------------------------------------------------%
|||+++++++|+++++|++++++++++++++++++++++++++++++++++++|------|
|||+++++++|+++++|++++++++++++++++++++++++++++++++++++++-----|
|||+++++++++++++++|++++++++++++++++++++++++++++++++++++-----|
|+l+++++++|+++++|++++++++++++++++++++++++++++++++++++++-++++|
|+|+++++++|+++++|++++++++++++++++++++++++++++++++++++-++++++|
|+|+++++++|+++++|++++++++++++++++++++++++++++++++++++++-++++|
|f|+++++++|+++++|++++++++++++++++++++++++++++++++++++++-----|
|+|+++++++|+++++|++++++++++++++++++++++++++++++++++++++-----|
|||+++++++|+++++|++++++++++++++++++++++++++++++++++++|------|
|||--------+++++--------------------------------------------|
||++++++++++++++++++++++++++++++++++++++++++++++++++++++++++|
||++++++++++++++++++++++++++++++++++++++++++++++++++++++++++|
||++++++++++++++++++++++++++++++++++++++++++++++++++++++++++|
||++++++++++++++++++++++++++++++++++++++++++++++++++++++++++|
||------------------------------+++++-----------------------|
||++++++++++++++|++++++++++++++|+++++|++++++++++++++++++++++|
|+++++++++++++++|++++++++++++++|+++++|++++++++++++++++++++++|
||++++++++++++++|++++++++++++++|+++++|++++++++++++++++++++++|
||++|++++++++++fl+++++++++++++++++++++++++++++++++++++++++++|
||++|+++++++++++|++++++++++++++|+++++|++++++++++++++++++++++|
|||++++++s++++--|++++++++++++++|+++++|++++++++++++++++++++++|
|++f++++++++++|++++++++++++++++|+++++|++++++++++++++++++++++|
|||+++++++++++|+|++++++++++++++|+++++|++++++++++++++++++++++|
||++++++++++++|+|++++++++++++++|+++++|++++++++++++++++++++++|
|||+|+++++++++|+|++++++++++++++|+++++|+++++++++++++++++++++u|
$-----------------------------------------------------------$