-----------------------------
|+++++++++++++++++++++++++++|
|+++++++++++++++++++++++++++|
|+++||||+|++++++||||||||++++|
|+++|++++|+++++++|+++++|++++|
|+++|++++|+++++++|+++++|++++|
|+++|++++|+++++++|+++++|++++|
|+++|++++|+++++++++++++|++++|
|+++||||||+++++++|||||||++++|
|+++++++++++++++++++++++++++|
||||+|++++++++++++++++++|+++|
|+++|++++|----------|+++++++|
|+++|++++|++++++++++++++++++|
|+++|++++|++++++++++++++++++|
|+++|++++|++++++++++++++++++|
|+++||||||++++++++++++++++++|
-----------------------------