#-----------------------$
|*`*,*,*`..`*.,`..`..`,.|
|.,*.*.`*`,.*`.*,*`..`.,|
|`,,**..`,*.`..*`,,...``|
|,,``...`.,`*``,*..`*.,,|
|,`...*,,`,,`,``,,...`*`|
|`,*,`,*.,*`.**.,*....`,|
|`,*,```,,.,.`,*`*`...`,|
|`,,*`.*`,*,*,,`....``,,|
|,,``...`.,`*``,*..`*.,`|
|`,*,`,*.,*`.**.,*....`.|
|`,*,```,,.,.`,*`*`...`.|
|.,*.*.`*`,.*`.*,*`..`.`|
|`,*,`,*.,*`.**.,*....``|
!-----------.-----------%